SAMPA	API
p	p
b	b
t	t
d	d
k	k
g	g
f	f
v	v
s	s
z	z
S	ʃ
Z	ȝ
j	j
m	m
n	n
J	ɲ
N	ŋ
l	l
R	ʁ
w	w
H	ɥ 
i	i
e	e
E	ɛ
a	a
A	ɑ
O	ɔ
o	o
u	u
y	y
2	ø
9	œ
@	ə
e~	ɛ̃
a~	ɑ̃
o~	ɔ̃
9~	œ̃